"filename", "language", "Dart", "comment", "blank", "total"
"/Users/alljavi/Documents/codigo/tucomunidad/lib/main.dart", "Dart", 204, 0, 13, 217
"/Users/alljavi/Documents/codigo/tucomunidad/lib/pages/addComunity.dart", "Dart", 94, 1, 10, 105
"/Users/alljavi/Documents/codigo/tucomunidad/lib/pages/create.dart", "Dart", 75, 1, 6, 82
"/Users/alljavi/Documents/codigo/tucomunidad/lib/pages/createPost.dart", "Dart", 109, 1, 10, 120
"/Users/alljavi/Documents/codigo/tucomunidad/lib/pages/createReunion.dart", "Dart", 260, 2, 14, 276
"/Users/alljavi/Documents/codigo/tucomunidad/lib/pages/createVotacion.dart", "Dart", 132, 1, 10, 143
"/Users/alljavi/Documents/codigo/tucomunidad/lib/pages/home.dart", "Dart", 142, 1, 12, 155
"/Users/alljavi/Documents/codigo/tucomunidad/lib/pages/instalaciones.dart", "Dart", 111, 1, 11, 123
"/Users/alljavi/Documents/codigo/tucomunidad/lib/pages/login.dart", "Dart", 151, 14, 16, 181
"/Users/alljavi/Documents/codigo/tucomunidad/lib/pages/notifications.dart", "Dart", 89, 1, 11, 101
"/Users/alljavi/Documents/codigo/tucomunidad/lib/streams/appbar.dart", "Dart", 11, 1, 5, 17
"/Users/alljavi/Documents/codigo/tucomunidad/lib/widgets/instalaciones.dart", "Dart", 276, 1, 11, 288
"/Users/alljavi/Documents/codigo/tucomunidad/lib/widgets/post.dart", "Dart", 192, 6, 8, 206
"/Users/alljavi/Documents/codigo/tucomunidad/lib/widgets/reuniones.dart", "Dart", 121, 1, 6, 128
"/Users/alljavi/Documents/codigo/tucomunidad/lib/widgets/votaciones.dart", "Dart", 143, 1, 7, 151
"Total", "-", 2110, 33, 150, 2293